00000000000000000000000000000000
00000000000000000000000000000000
00000000110000000000011110000000
00000000000011110000000000000000
00011111110000000000000000000000
00000000000000000000000000000000
00000000000111111111100000000000
00000000000000000000111100000000
00000000000000000000001111111110
00000000000000000000000000000000
00000001000001111111111110000000
11111111110000000000000000000000
00000000000000000111111111100000
11111110000000000000000000000000
00000000000000000000011111111110
00000000000000000011111100000000
00000000000111100000100000000000
11111111111111111111111111111111
